13,16,16,3,0,0,0,6,10,3
6,6,13,3,3,0,6,10,9,0
10,3,3,6,10,6,10,9,10,3
6,0,3,10,6,3,3,0,3,3
20,3,0,6,3,23,3,3,6,10
6,0,3,13,6,13,6,13,13,9
10,3,6,16,3,6,3,3,9,30
3,3,13,16,6,13,26,6,13,6
0,0,3,3,0,6,13,6,13,3
0,0,0,0,0,0,3,0,3,0
