3,10,3,0,0,6,10,3,0,3
3,3,0,0,6,10,6,0,3,20
10,3,0,3,10,6,3,3,0,3
3,0,0,3,3,3,13,13,6,3
3,0,3,10,6,0,3,6,13,16
10,3,0,9,13,3,0,0,9,13
3,0,3,13,26,6,0,6,10,6
0,3,0,3,6,10,9,10,6,0
3,10,3,0,0,6,10,6,0,0
0,3,0,0,0,0,3,0,0,0
