0,0,6,10,6,3,10,9,10,3
0,3,23,9,10,3,9,10,9,0
0,3,16,3,6,3,10,12,10,3
3,3,16,6,10,6,9,10,6,3
10,6,13,6,9,13,13,6,6,13
3,0,6,23,13,9,3,3,13,16
3,3,3,6,6,10,3,0,3,3
16,16,19,23,6,3,0,3,0,3
13,9,13,9,10,3,3,10,6,10
3,0,3,0,3,0,0,3,0,3
