3,0,3,10,6,10,3,0,3,0
10,3,0,3,0,6,0,6,20,3
3,0,0,3,3,10,6,10,9,0
0,3,3,10,3,3,0,9,10,3
3,13,3,3,0,0,6,10,6,3
3,13,3,3,0,3,20,9,3,13
0,3,3,13,6,0,6,13,9,13
0,3,3,16,16,3,3,29,23,6
3,10,3,6,13,3,3,23,6,0
0,3,0,0,3,0,0,3,0,0
