10,3,0,3,10,9,20,6,10,3
3,0,3,3,6,13,9,3,3,0
0,6,16,13,6,16,16,23,6,0
6,23,16,6,3,6,3,6,20,3
13,6,3,6,13,13,3,0,6,0
13,3,6,13,6,6,3,3,23,3
6,3,13,16,6,16,13,9,13,3
13,6,6,3,6,13,9,23,9,0
16,16,13,6,10,6,3,16,13,3
3,3,3,0,3,0,0,3,3,0
