0,6,10,3,0,3,10,3,0,0
3,13,9,0,0,0,3,0,0,0
3,16,13,3,0,0,0,0,0,3
3,6,3,3,3,3,0,3,3,10
13,13,9,13,16,13,6,13,3,3
3,6,10,6,3,3,3,16,6,3
0,3,3,0,0,0,3,16,16,13
3,10,6,0,0,0,0,6,3,3
0,6,10,3,0,0,3,10,3,0
0,0,3,0,0,0,0,3,0,0
