20,3,3,3,13,16,3,3,0,0
3,3,13,3,6,16,6,13,3,0
0,6,13,3,3,13,9,13,3,0
6,10,6,0,0,9,10,6,3,3
13,6,0,0,3,10,6,6,13,13
16,3,0,3,0,6,3,23,6,3
16,3,3,10,6,13,9,16,6,3
13,3,3,3,3,16,16,19,16,13
3,3,10,3,0,3,3,3,3,3
0,0,3,0,0,0,0,0,0,0
