0,0,3,10,3,3,0,0,3,0
3,0,0,3,3,10,3,3,10,6
10,6,3,3,0,6,0,3,6,10
6,13,16,23,9,13,6,10,3,3
0,3,6,6,13,19,3,6,0,3
0,6,10,3,9,13,6,10,6,10
3,13,9,3,10,9,0,6,0,3
3,16,13,3,6,13,6,13,3,3
0,3,3,0,3,13,6,13,6,20
0,0,0,0,0,3,0,3,0,3
