3,0,0,3,0,3,13,9,10,3
20,6,3,20,3,3,16,26,9,0
6,13,3,3,0,0,9,16,13,3
3,16,3,3,0,3,10,6,3,0
3,16,6,10,3,0,3,0,0,0
3,13,6,6,3,0,0,3,0,0
0,9,13,16,16,3,6,13,3,3
6,10,6,6,16,6,16,16,6,13
10,6,0,3,23,6,13,6,3,13
3,0,0,0,3,0,3,0,0,3
