10,3,3,0,3,13,16,6,13,3
3,3,13,6,0,9,16,9,23,3
0,3,19,13,6,13,19,13,6,0
0,6,26,6,0,3,6,3,3,0
6,23,16,6,0,3,10,9,13,3
13,6,6,10,6,0,6,13,16,6
13,3,3,6,10,3,3,3,6,20
3,3,10,3,3,3,23,3,3,3
0,0,3,0,0,3,13,6,10,3
0,0,0,0,0,0,3,0,3,0
