10,3,3,3,20,3,0,0,0,0
3,3,10,6,6,0,3,3,3,3
0,0,6,16,23,6,13,26,16,13
3,0,3,13,9,0,3,3,3,6
10,3,3,6,10,6,0,0,3,10
3,6,10,3,6,10,6,0,0,3
3,13,9,0,3,9,10,6,0,0
3,16,13,9,13,16,9,13,3,3
0,3,6,10,9,13,6,23,6,10
0,0,0,3,0,3,0,3,0,3
