0,6,10,6,0,3,13,23,3,0
6,10,9,10,3,0,6,3,3,3
10,6,3,6,0,3,23,9,13,13
3,3,13,16,6,3,19,13,6,6
0,0,6,16,13,6,13,9,3,13
0,0,0,3,3,3,6,20,9,13
0,0,0,0,3,20,3,6,10,6
0,0,0,3,0,6,0,0,6,0
0,0,3,10,6,10,3,3,10,3
0,0,0,3,0,3,0,0,3,0
