10,3,3,10,6,6,10,6,0,0
3,3,0,9,13,13,9,10,3,3
6,13,6,10,6,3,0,3,3,13
13,19,3,6,3,3,0,0,6,13
9,13,6,13,16,13,3,3,10,6
13,6,0,3,3,3,0,3,3,3
16,6,3,0,3,0,3,10,6,10
19,16,13,6,13,3,0,3,0,6
13,6,3,3,13,3,0,0,3,10
3,0,0,0,3,0,0,0,0,3
