0,0,6,20,3,3,3,0,3,0
3,6,10,9,3,23,13,6,20,3
13,13,9,10,3,3,3,3,3,3
6,3,0,3,0,0,3,33,6,10
13,6,0,0,0,3,3,13,3,3
19,13,3,3,3,10,3,6,0,3
13,9,6,10,3,3,6,10,6,10
9,13,13,6,0,3,10,6,0,3
10,6,3,0,0,0,3,0,0,0
3,0,0,0,0,0,0,0,0,0
