3,0,0,3,10,6,0,0,0,3
13,3,0,3,6,13,3,0,3,10
23,3,3,10,9,23,3,0,3,3
6,0,0,9,10,9,0,3,10,3
23,3,3,10,9,10,3,0,6,0
13,6,0,3,3,3,0,6,13,6
6,10,6,3,23,3,3,13,19,13
0,9,10,9,16,6,0,3,3,6
3,10,9,13,19,13,3,0,3,10
0,3,0,3,3,3,0,0,0,3
