3,13,3,0,3,3,3,6,23,3
3,16,3,3,16,19,16,16,26,3
6,13,3,3,16,16,6,6,3,0
13,6,0,0,3,6,3,20,3,0
33,3,3,0,6,20,3,3,0,0
3,3,20,9,10,6,0,0,0,0
0,0,9,10,9,3,3,3,0,3
3,3,10,9,16,29,26,23,6,23
10,3,3,3,26,16,6,3,3,13
3,0,0,0,3,3,0,0,0,3
