3,0,0,0,3,13,16,13,6,0
10,3,0,0,3,3,3,9,10,3
6,0,0,3,10,6,3,10,6,0
10,3,3,0,6,20,6,6,0,0
3,6,10,3,3,6,13,13,6,3
3,10,6,3,13,6,3,6,16,13
0,6,0,6,16,23,6,6,13,9
3,10,9,10,9,9,13,13,9,13
0,6,10,9,13,13,6,3,3,13
0,0,3,0,3,3,0,0,0,3
