0,0,0,0,3,3,20,6,0,0
0,0,0,3,10,6,6,10,3,0
0,0,0,0,9,10,3,3,0,0
3,0,0,3,10,6,3,0,0,0
10,3,3,3,3,3,13,3,0,3
3,3,16,23,6,6,13,6,3,10
0,6,13,12,13,13,9,13,3,6
3,10,12,10,6,3,3,13,6,13
0,6,20,6,0,0,0,3,3,13
0,0,3,0,0,0,0,0,0,3
