0,3,10,3,0,3,0,0,3,0
0,0,3,0,3,13,3,3,13,6
0,3,0,0,3,26,3,3,19,13
3,20,3,3,3,13,3,6,13,6
0,3,3,20,3,3,3,10,9,3
0,3,3,3,0,0,0,6,13,16
3,13,16,3,3,0,0,0,6,16
3,6,13,9,13,3,0,3,6,13
10,3,6,13,16,3,3,13,23,6
3,0,0,3,3,0,0,3,3,0
