13,3,3,10,6,20,3,0,3,3
16,3,0,3,0,3,3,3,16,13
13,3,0,3,0,3,10,6,13,6
3,3,3,10,6,3,3,3,6,0
6,13,3,6,13,26,6,33,16,3
16,16,3,0,6,16,3,6,16,3
13,9,0,0,3,23,3,6,16,3
6,10,3,3,3,3,3,16,19,3
0,3,3,13,13,3,3,16,16,3
0,0,0,3,3,0,0,3,3,0
