3,10,6,10,3,6,13,6,0,3
0,3,0,3,3,13,22,16,6,10
0,3,0,3,3,6,16,16,6,3
6,13,9,13,13,3,6,9,10,3
13,19,13,6,3,3,16,16,6,0
3,6,6,3,0,3,19,26,3,0
3,13,26,13,3,3,23,6,3,0
0,6,3,6,0,3,6,6,13,3
3,10,6,10,6,13,16,16,16,3
0,3,0,3,0,3,3,3,3,0
