3,3,0,0,0,0,0,0,0,0
16,16,3,0,0,0,0,3,0,3
19,16,3,0,0,0,6,13,9,13
16,9,3,0,0,3,16,19,19,19
16,16,16,3,0,3,13,9,19,29
3,6,13,3,0,0,3,6,16,16
3,3,3,0,0,0,3,10,6,3
13,13,6,0,3,0,0,6,0,3
3,6,10,6,10,3,3,20,6,20
0,0,3,0,3,0,0,3,0,3
