3,10,3,3,0,3,10,3,0,0
3,3,3,10,6,3,3,0,3,0
33,6,0,9,13,13,3,3,20,3
16,13,9,10,6,3,0,0,3,0
6,6,10,6,0,0,0,3,0,0
10,3,3,0,0,0,3,13,3,0
3,0,3,3,3,0,3,13,3,3
3,3,13,16,23,3,3,3,6,10
10,3,3,3,3,3,10,6,10,6
3,0,0,0,0,0,3,0,3,0
