3,6,10,3,3,13,3,0,3,3
13,13,6,3,6,16,3,3,13,13
3,6,3,26,16,19,6,0,3,3
3,10,6,16,9,19,23,3,0,3
0,6,3,13,6,16,9,3,3,13
6,10,6,6,3,16,16,36,6,13
10,9,16,23,6,3,6,13,3,3
3,3,13,9,13,6,0,3,0,0
0,0,3,3,16,13,3,0,0,0
0,0,0,0,3,3,0,0,0,0
