10,3,3,13,6,16,13,6,3,0
3,0,6,13,6,16,9,13,23,3
3,6,13,6,3,16,3,3,3,0
13,16,29,3,3,13,3,0,3,0
3,6,13,3,0,3,0,3,10,3
0,0,3,3,3,0,3,0,3,3
0,0,3,13,23,6,13,3,3,10
0,3,3,3,3,6,16,3,3,3
3,23,13,3,3,13,16,6,10,3
0,3,3,0,0,3,3,0,3,0
