0,0,3,10,6,13,6,13,3,0
3,0,0,3,3,13,6,26,6,0
13,6,0,0,0,6,3,19,16,3
16,13,3,0,3,10,9,16,19,3
3,3,0,0,0,9,10,9,13,3
0,0,0,3,3,13,6,3,3,0
0,0,6,10,6,13,6,10,6,0
0,3,10,6,3,6,0,6,10,6
0,0,3,3,23,13,3,0,6,10
0,0,0,0,3,3,0,0,0,3
