0,0,0,0,0,0,3,0,0,0
3,3,0,3,0,6,10,3,0,0
13,16,9,10,6,10,6,0,0,0
6,16,13,9,3,3,0,0,0,0
0,3,6,13,13,6,0,0,0,0
3,0,0,6,9,13,6,0,0,3
10,3,6,26,16,19,16,3,6,10
3,3,16,16,6,9,23,6,13,9
0,3,13,6,3,10,6,3,16,13
0,0,3,0,0,3,0,0,3,3
