3,10,3,0,0,3,10,3,3,0
0,3,3,0,0,3,3,6,10,3
0,3,13,3,3,13,6,10,6,0
3,3,26,6,6,13,3,3,3,0
13,6,16,19,13,6,0,6,10,6
13,3,9,23,6,0,6,10,12,10
3,3,13,6,0,3,13,9,10,9
0,3,13,6,0,6,13,3,9,10
0,0,6,10,6,10,6,3,10,6
0,0,0,3,0,3,0,0,3,0
