0,0,0,0,0,0,3,0,0,0
0,0,0,0,3,3,20,3,0,0
3,0,0,3,13,6,6,0,0,3
10,6,3,3,16,16,13,3,3,10
6,16,13,3,6,3,3,3,0,6
6,13,9,6,13,3,6,10,6,10
23,9,23,19,16,6,23,6,0,6
13,3,6,13,6,6,13,6,6,13
3,0,0,3,3,10,9,13,16,16
0,0,0,0,0,3,0,3,3,3
