0,0,3,3,13,3,3,3,13,3
0,3,13,9,13,6,13,6,16,3
3,3,19,13,9,6,13,9,16,3
13,9,16,12,13,16,9,13,16,3
26,16,19,16,12,13,3,3,6,0
3,3,6,16,13,6,0,3,20,3
0,0,3,3,6,0,3,0,3,0
0,3,10,6,13,6,10,6,3,3
0,0,3,3,13,3,6,13,16,13
0,0,0,0,3,0,0,3,3,3
