6,13,19,16,16,6,0,0,0,0
10,9,16,9,16,13,3,3,0,3
3,3,23,3,6,3,3,10,9,10
0,0,3,3,13,3,0,6,20,9
3,0,3,3,13,3,3,0,9,10
10,6,10,6,3,3,13,6,10,6
3,0,9,10,3,6,16,3,6,0
3,3,10,6,6,16,26,9,10,6
10,3,3,3,13,16,9,10,9,20
3,0,0,0,3,3,0,3,0,3
