23,3,0,3,3,13,13,3,3,0
16,3,6,13,3,3,6,3,10,6
13,6,16,16,3,3,10,3,9,30
3,3,13,9,0,0,3,3,13,6
0,0,6,13,6,0,0,3,13,6
3,3,3,16,13,6,0,3,9,10
16,13,6,3,6,10,6,13,23,9
13,9,23,3,0,3,0,3,6,10
3,3,23,3,0,0,0,0,0,3
0,0,3,0,0,0,0,0,0,0
