3,20,6,3,0,0,6,10,3,0
0,6,13,13,3,3,10,6,0,0
0,3,3,3,0,0,3,0,0,0
6,13,6,0,0,3,0,0,0,3
26,19,13,3,6,10,3,3,3,13
23,6,3,6,10,6,3,10,6,26
6,3,3,13,6,0,0,3,3,13
13,13,6,13,6,0,3,0,0,3
3,3,0,6,10,6,10,3,0,0
0,0,0,0,3,0,3,0,0,0
