3,23,3,6,10,3,3,0,0,0
6,16,6,13,6,6,23,6,0,0
13,16,6,23,6,16,19,13,3,0
6,6,0,3,3,13,6,3,3,0
23,16,3,3,0,6,0,3,30,3
6,13,6,10,6,13,3,3,3,0
0,6,0,3,3,13,9,13,3,0
3,10,6,0,3,6,13,16,6,0
0,6,10,6,10,3,3,6,10,3
0,0,3,0,3,0,0,0,3,0
