3,0,3,13,13,6,3,13,13,3
10,3,3,3,6,23,6,3,3,3
3,3,10,6,3,16,13,3,6,10
0,0,6,10,3,3,3,3,10,9
0,0,3,3,0,0,0,3,6,10
3,3,23,3,3,0,6,13,6,3
13,6,13,6,13,6,13,19,16,3
13,3,3,6,16,3,3,6,23,3
3,0,3,13,16,3,0,0,3,0
0,0,0,3,3,0,0,0,0,0
