3,0,3,0,0,3,0,3,10,3
10,6,10,3,3,13,3,0,6,3
3,0,3,0,3,23,3,3,23,13
3,0,3,0,0,6,0,3,3,3
13,6,20,3,3,10,6,13,3,3
13,6,6,3,3,3,3,13,6,13
6,13,29,19,13,3,0,6,6,16
0,9,16,16,9,0,6,16,19,16
3,10,6,6,10,6,13,19,16,6
0,3,0,0,3,0,3,3,3,0
