6,10,6,16,16,13,3,3,3,0
10,6,6,13,6,3,3,13,16,3
3,3,10,9,0,3,3,6,13,3
3,3,6,13,6,16,13,3,3,3
13,16,6,13,9,13,9,0,3,20
6,13,6,9,23,12,13,3,0,6
3,6,13,16,22,16,19,3,3,20
20,3,3,9,13,9,13,3,0,6
3,0,3,10,6,0,3,0,3,10
0,0,0,3,0,0,0,0,0,3
