0,3,16,13,9,13,13,6,10,3
3,6,16,12,13,6,3,0,3,3
16,16,22,16,19,3,0,0,3,13
13,12,13,12,16,3,0,0,3,13
9,13,9,16,29,3,3,0,0,6
13,26,6,19,16,9,20,3,6,13
3,6,3,13,9,13,6,6,23,26
3,20,6,6,6,13,6,10,6,3
0,6,13,16,13,6,0,3,0,0
0,0,3,3,3,0,0,0,0,0
