3,10,3,3,10,6,10,6,0,0
0,6,0,3,6,0,6,10,3,0
6,13,6,23,16,3,0,3,0,3
16,16,3,6,16,6,0,0,3,10
13,6,3,3,16,16,3,0,3,3
3,3,10,6,6,13,3,6,13,6
0,0,6,13,3,6,3,13,19,23
0,0,3,13,9,10,6,3,6,3
0,0,0,6,10,9,10,6,20,3
0,0,0,0,3,0,3,0,3,0
