10,6,10,3,3,0,3,0,0,0
3,3,3,3,10,9,10,6,3,0
3,30,3,3,6,10,12,13,26,3
0,3,3,10,3,6,13,9,13,3
0,0,3,6,0,6,13,3,6,0
0,3,16,13,6,10,6,3,23,3
0,3,13,6,3,6,3,3,13,6
0,0,3,3,13,16,13,6,6,13
0,0,0,0,3,3,6,20,6,13
0,0,0,0,0,0,0,3,0,3
