0,3,3,13,6,6,20,3,0,0
3,10,6,16,16,13,6,3,0,0
0,3,0,6,6,3,3,10,3,0
0,0,3,26,13,3,3,6,0,0
3,0,3,23,6,3,16,13,3,3
10,3,0,6,0,6,16,9,3,13
3,0,3,10,6,13,22,16,6,16
3,0,3,3,0,6,16,19,6,13
10,6,20,3,0,0,6,13,3,3
3,0,3,0,0,0,0,3,0,0
