0,0,3,3,3,13,6,10,3,0
0,3,13,16,6,13,3,3,3,0
0,3,9,16,3,3,3,3,13,3
3,13,16,19,3,3,10,6,23,6
0,3,9,13,3,3,6,3,6,13
0,3,23,6,3,26,16,13,9,16
3,3,13,6,3,13,6,9,13,16
13,6,6,13,6,6,3,10,6,6
26,23,6,26,26,13,3,3,3,10
3,3,0,3,3,3,0,0,0,3
