10,6,10,6,0,6,10,3,0,0
3,0,6,10,6,13,9,0,0,0
0,0,0,3,3,16,13,3,3,0
3,0,3,3,3,6,6,3,20,3
13,6,23,16,16,29,13,3,6,3
13,3,6,3,6,13,9,6,16,23
3,6,20,6,3,6,13,16,16,9
3,10,9,13,13,3,6,3,9,10
0,3,0,3,3,3,10,6,10,6
0,0,0,0,0,0,3,0,3,0
