3,26,23,6,13,6,10,3,0,0
3,13,9,3,13,6,3,0,0,3
0,9,10,6,6,10,6,0,3,10
6,13,9,10,3,6,13,3,0,6
13,16,3,3,0,3,13,3,3,13
3,6,0,0,0,0,3,3,6,13
3,10,6,0,0,0,6,23,16,6
0,6,10,3,0,6,10,12,13,3
0,0,3,0,3,10,9,10,6,0
0,0,0,0,0,3,0,3,0,0
