10,6,10,3,0,0,3,3,3,3
3,3,3,3,0,6,26,16,16,13
6,33,6,13,6,16,19,9,3,3
13,29,6,16,6,16,19,13,3,0
6,16,9,16,6,3,6,6,0,0
3,19,16,19,13,6,13,16,6,0
6,23,6,3,3,0,6,16,16,6
10,9,0,0,0,0,0,6,16,16
6,10,3,0,0,0,0,0,6,23
0,3,0,0,0,0,0,0,0,3
