0,0,0,0,0,0,3,20,3,3
3,0,0,0,0,0,0,6,6,10
13,6,0,0,0,3,3,13,16,6
16,16,6,0,6,13,3,6,13,3
6,16,16,6,13,19,3,0,3,0
3,6,16,3,6,13,3,0,0,3
10,6,16,3,0,6,3,0,3,13
3,3,26,3,6,23,23,3,3,13
0,3,13,6,10,6,3,0,0,3
0,0,3,0,3,0,0,0,0,0
