3,3,0,3,0,3,3,3,0,3
13,16,6,10,9,16,16,13,6,10
6,13,3,6,13,16,9,3,3,3
3,6,0,0,3,6,10,6,10,3
26,13,3,0,3,0,6,0,3,0
13,9,0,3,10,6,10,6,0,3
9,13,6,3,3,0,9,10,6,10
16,19,16,13,6,3,10,6,0,3
13,6,3,6,10,3,3,0,0,0
3,0,0,0,3,0,0,0,0,0
