13,3,3,0,6,10,6,3,0,0
16,6,23,6,10,9,13,13,3,3
13,6,16,6,3,0,3,6,3,10
6,3,19,13,3,0,3,13,6,3
33,6,13,6,3,0,3,16,16,6
23,3,3,3,13,6,0,6,16,13
3,0,0,3,16,13,3,0,3,3
3,0,0,3,3,3,0,3,0,3
10,3,3,10,3,0,3,10,6,10
3,0,0,3,0,0,0,3,0,3
